quadrúpede	adjetivo	qua|[drú]|pe|de
quadrúpede	nome feminino	qua|[drú]|pe|de
quadruplar	verbo	qua|dru|[plar]
quadrupleta	nome feminino	qua|dru|[ple]|ta
quadruplicação	nome feminino	qua|dru|pli|ca|[ção]
quadruplicadamente	advérbio	qua|dru|pli|ca|da|[men]|te
quadruplicado	adjetivo	qua|dru|pli|[ca]|do
quadruplicado	nome masculino	qua|dru|pli|[ca]|do
quadruplicador	adjetivo	qua|dru|pli|ca|[dor]
quadruplicador	nome masculino	qua|dru|pli|ca|[dor]
quadruplicar	verbo	qua|dru|pli|[car]
quadruplicável	adjetivo	qua|dru|pli|[cá]|vel
quádruplo	número multiplicativo	[quá]|dru|plo
quádruplo	nome masculino	[quá]|dru|plo
quádruplo	adjetivo	[quá]|dru|plo
quadrusse	nome masculino	qua|[drus]|se
quadrússis	nome masculino	qua|[drús]|sis
quaiapá	nome masculino	quai|a|[pá]
quaitsi	adjetivo	quait|[si]
quaitsi	nome masculino	quait|[si]
qual	pronome interrogativo	[qual]
qual	artigo interrogativo	[qual]
qual	pronome relativo	[qual]
qual	conjunção	[qual]
qual	interjeição	[qual]
qual	pronome indefinido	[qual]
quáli	nome masculino	[quá]|li
qualidade	nome feminino	qua|li|[da]|de
qualificação	nome feminino	qua|li|fi|ca|[ção]
qualificadamente	advérbio	qua|li|fi|ca|da|[men]|te
qualificado	adjetivo	qua|li|fi|[ca]|do
qualificador	adjetivo	qua|li|fi|ca|[dor]
qualificador	nome masculino	qua|li|fi|ca|[dor]
qualificante	adjetivo	qua|li|fi|[can]|te
qualificar	verbo	qua|li|fi|[car]
qualificativamente	advérbio	qua|li|fi|ca|ti|va|[men]|te
qualificativo	adjetivo	qua|li|fi|ca|[ti]|vo
qualificativo	nome masculino	qua|li|fi|ca|[ti]|vo
qualificável	adjetivo	qua|li|fi|[cá]|vel
qualifying	nome masculino	qua|li|fy|ing
qualitativamente	advérbio	qua|li|ta|ti|va|[men]|te
qualitativo	adjetivo	qua|li|ta|[ti]|vo
qualquer	artigo indefinido	qual|[quer]
quamato	adjetivo	qua|[ma]|to
quamato	nome masculino	qua|[ma]|to
quamátui	adjetivo	qua|[má]|tui
quamátui	nome masculino	qua|[má]|tui
quando	conjunção	[quan]|do
quando	advérbio	[quan]|do
quanhama	adjetivo	qua|[nha]|ma
quanhama	nome masculino	qua|[nha]|ma
quaniama	adjetivo	qua|ni|[a]|ma
quaniama	nome masculino	qua|ni|[a]|ma
quanta	nome masculino	[quan]|ta
quantia	nome feminino	quan|[ti]|a
quantiar	verbo	quan|ti|[ar]
quântico	adjetivo	[quân]|ti|co
quantidade	nome feminino	quan|ti|[da]|de
quantificação	nome feminino	quan|ti|fi|ca|[ção]
quantificado	adjetivo	quan|ti|fi|[ca]|do
quantificador	nome masculino	quan|ti|fi|ca|[dor]
quantificador	adjetivo	quan|ti|fi|ca|[dor]
quantificar	verbo	quan|ti|fi|[car]
quantificável	adjetivo	quan|ti|fi|[cá]|vel
quantil	nome masculino	quan|[til]
quantiosamente	advérbio	quan|ti|o|sa|[men]|te
quantioso	adjetivo	quan|ti|[o]|so
quantitativamente	advérbio	quan|ti|ta|ti|va|[men]|te
quantitativo	adjetivo	quan|ti|ta|[ti]|vo
quantitativo	nome masculino	quan|ti|ta|[ti]|vo
quanto	nome masculino	[quan]|to
quanto	advérbio	[quan]|to
quanto	artigo interrogativo	[quan]|to
quanto	pronome interrogativo	[quan]|to
quanto	conjunção	[quan]|to
quanto	pronome relativo	[quan]|to
quanto	artigo indefinido	[quan]|to
quanto	pronome indefinido	[quan]|to
quantofrenia	nome feminino	quan|to|fre|[ni]|a
quantum	nome masculino	quan|[tum]
quanza	nome masculino	[quan]|za
quão	advérbio	qu|[ão]
quapoia	nome feminino	qua|[poi]|a
quarador	nome masculino	qua|ra|[dor]
quarar	verbo	qua|[rar]
quárcico	adjetivo	[quár]|ci|co
quarcífero	adjetivo	quar|[cí]|fe|ro
quarciforme	adjetivo	quar|ci|[for]|me
quarcite	nome feminino	quar|[ci]|te
quarço	nome masculino	[quar]|ço
quarçoso	adjetivo	quar|[ço]|so
quarenta	nome masculino	qua|[ren]|ta
quarenta	número cardinal	qua|[ren]|ta
quarenta	adjetivo	qua|[ren]|ta
quarentão	adjetivo	qua|ren|[tão]
quarentão	nome masculino	qua|ren|[tão]
quarentar	verbo	qua|ren|[tar]
quarentena	nome feminino	qua|ren|[te]|na
quarentenar	verbo	qua|ren|te|[nar]
quarentenário	nome masculino	qua|ren|te|[ná]|ri|o
quentão	nome masculino	quen|[tão]
quentar	verbo	quen|[tar]
quente	nome masculino	[quen]|te
quente	adjetivo	[quen]|te
quentura	nome feminino	quen|[tu]|ra
quepe	nome masculino	[que]|pe
quépi	nome masculino	[qué]|pi
queque	nome masculino	[que]|que
queque	adjetivo	[que]|que
quer	conjunção	[quer]
quera	adjetivo	[que]|ra
querar	verbo	que|[rar]
queratina	nome feminino	que|ra|[ti]|na
queratinização	nome feminino	que|ra|ti|ni|za|[ção]
queratinizar	verbo	que|ra|ti|ni|[zar]
queratinoso	adjetivo	que|ra|ti|[no]|so
queratite	nome feminino	que|ra|[ti]|te
queratose	nome feminino	que|ra|[to]|se
queratotomia	nome feminino	que|ra|to|to|[mi]|a
quercina	nome feminino	quer|[ci]|na
quercíneo	adjetivo	quer|[cí]|ne|o
quercite	nome feminino	quer|[ci]|te
quercitrina	nome feminino	quer|ci|[tri]|na
querco	nome masculino	[quer]|co
querela	nome feminino	que|[re]|la
querelada	nome feminino	que|re|[la]|da
querelado	nome masculino	que|re|[la]|do
querelado	adjetivo	que|re|[la]|do
querelador	adjetivo	que|re|la|[dor]
querelador	nome masculino	que|re|la|[dor]
querelante	adjetivo	que|re|[lan]|te
querelante	nome masculino	que|re|[lan]|te
querelante	nome feminino	que|re|[lan]|te
querelar	verbo	que|re|[lar]
querelável	adjetivo	que|re|[lá]|vel
querelosa	nome feminino	que|re|[lo]|sa
quereloso	adjetivo	que|re|[lo]|so
quereloso	nome masculino	que|re|[lo]|so
querena	nome feminino	que|[re]|na
querenagem	nome feminino	que|re|[na]|gem
querenar	verbo	que|re|[nar]
querença	nome feminino	que|[ren]|ça
querenceiro	adjetivo	que|ren|[cei]|ro
querência	nome feminino	que|[rên]|ci|a
querenciar	verbo	que|ren|ci|[ar]
querenço	nome masculino	que|[ren]|ço
querençoso	adjetivo	que|ren|[ço]|so
querençudo	adjetivo	que|ren|[çu]|do
querendão	nome masculino	que|ren|[dão]
querendão	adjetivo	que|ren|[dão]
querendar	verbo	que|ren|[dar]
querendeiro	adjetivo	que|ren|[dei]|ro
quereneiro	nome masculino	que|re|[nei]|ro
querente	adjetivo	que|[ren]|te
querentim	nome masculino	que|ren|[tim]
querequexé	nome masculino	que|re|que|[xé]
querer	nome masculino	que|[rer]
querer	verbo	que|[rer]
querida	nome feminino	que|[ri]|da
querido	adjetivo	que|[ri]|do
querido	nome masculino	que|[ri]|do
querilio	adjetivo	que|ri|[li]|o
querilio	nome masculino	que|ri|[li]|o
querimónia	nome feminino	que|ri|[mó]|ni|a
querimônia	nome feminino	que|ri|[mô]|ni|a
quermes	nome masculino	[quer]|mes
quermésida	nome masculino	quer|[mé]|si|da
quermesídeo	nome masculino	quer|me|[sí]|de|o
quermesídeo	adjetivo	quer|me|[sí]|de|o
quermesite	nome feminino	quer|me|[si]|te
quermesse	nome feminino	quer|[mes]|se
quernetídeo	nome masculino	quer|ne|[tí]|de|o
quernite	nome feminino	quer|[ni]|te
quero-mana	nome masculino	que|ro-ma|na
quero-quero	nome masculino	que|ro-que|ro
queroneu	adjetivo	que|ro|[neu]
queroneu	nome masculino	que|ro|[neu]
querosenagem	nome feminino	que|ro|se|[na]|gem
querosenar	verbo	que|ro|se|[nar]
querosene	nome masculino	que|ro|[se]|ne
quérquera	nome feminino	[quér]|que|ra
querquerno	adjetivo	quer|[quer]|no
querquerno	nome masculino	quer|[quer]|no
querquetulano	adjetivo	quer|que|tu|[la]|no
querquetulano	nome masculino	quer|que|tu|[la]|no
querróbia	nome feminino	quer|[ró]|bi|a
querronense	nome masculino	quer|ro|[nen]|se
querronense	adjetivo	quer|ro|[nen]|se
querronense	nome feminino	quer|ro|[nen]|se
querruxe	interjeição	quer|[ru]|xe
quersídeo	nome masculino	quer|[sí]|de|o
quersonense	adjetivo	quer|so|[nen]|se
quersonense	nome masculino	quer|so|[nen]|se
quersonense	nome feminino	quer|so|[nen]|se
quersonésio	adjetivo	quer|so|[né]|si|o
quersonésio	nome masculino	quer|so|[né]|si|o
quersoneso	nome masculino	quer|so|[ne]|so
querubim	nome masculino	que|ru|[bim]
querubíneo	adjetivo	que|ru|[bí]|ne|o
querubínico	adjetivo	que|ru|[bí]|ni|co
quitação	nome feminino	qui|ta|[ção]
quitador	adjetivo	qui|ta|[dor]
quitador	nome masculino	qui|ta|[dor]
quitadora	nome feminino	qui|ta|[do]|ra
quitambuera	adjetivo	qui|tam|bu|[e]|ra
quitambuera	nome feminino	qui|tam|bu|[e]|ra
quitamento	nome masculino	qui|ta|[men]|to
quitança	nome feminino	qui|[tan]|ça
quitanda	nome feminino	qui|[tan]|da
quitandar	verbo	qui|tan|[dar]
quitandeira	nome feminino	qui|tan|[dei]|ra
quitandeiro	nome masculino	qui|tan|[dei]|ro
quitanga	nome feminino	qui|[tan]|ga
quitante	adjetivo	qui|[tan]|te
quitante	nome masculino	qui|[tan]|te
quitante	nome feminino	qui|[tan]|te
quitão	nome masculino	qui|[tão]
quitar	verbo	qui|[tar]
quitare	nome masculino	qui|[ta]|re
quite	nome masculino	[qui]|te
quite	adjetivo	[qui]|te
quitece	nome masculino	qui|[te]|ce
quitemente	advérbio	qui|te|[men]|te
quitenho	adjetivo	qui|[te]|nho
quitenho	nome masculino	qui|[te]|nho
quitetas	nome feminino	qui|[te]|tas
quiteve	nome masculino	qui|[te]|ve
quiti	nome masculino	qui|[ti]
quitia	nome feminino	qui|[ti]|a
quitiaquenene	nome masculino	qui|ti|a|que|[ne]|ne
quitina	nome feminino	qui|[ti]|na
quitinóforo	nome masculino	qui|ti|[nó]|fo|ro
quitinoso	adjetivo	qui|ti|[no]|so
quitó	nome masculino	qui|[tó]
quito	nome masculino	[qui]|to
quitoco	nome masculino	qui|[to]|co
quitólis	nome masculino	qui|[tó]|lis
quíton	nome masculino	[quí]|ton
quitôni	nome masculino	qui|[tô]|ni
quitóni	nome masculino	qui|[tó]|ni
quitonídeo	nome masculino	qui|to|[ní]|de|o
quitoto	nome masculino	qui|[to]|to
quitué	nome masculino	qui|tu|[é]
quituio	nome masculino	qui|[tui]|o
quitumbata	nome feminino	qui|tum|[ba]|ta
quitundo	nome masculino	qui|[tun]|do
quitundulo	nome masculino	qui|tun|[du]|lo
quitungo	nome masculino	qui|[tun]|go
quitura	nome feminino	qui|[tu]|ra
quitute	nome masculino	qui|[tu]|te
quituteiro	adjetivo	qui|tu|[tei]|ro
quituteiro	nome masculino	qui|tu|[tei]|ro
quituxe	nome masculino	qui|[tu]|xe
quituza	nome feminino	qui|[tu]|za
quiúto	nome masculino	qui|[ú]|to
quiúza	nome feminino	qui|[ú]|za
quivi	nome masculino	qui|[vi]
quivória	nome feminino	qui|[vó]|ri|a
quivúvi	nome masculino	qui|[vú]|vi
quixaba	nome feminino	qui|[xa]|ba
quixabeira	nome feminino	qui|xa|[bei]|ra
quixeramobinense	adjetivo	qui|xe|ra|mo|bi|[nen]|se
quixeramobinense	nome masculino	qui|xe|ra|mo|bi|[nen]|se
quixeramobinense	nome feminino	qui|xe|ra|mo|bi|[nen]|se
quixibá	nome masculino	qui|xi|[bá]
quixicongo	nome masculino	qui|xi|[con]|go
quixiligangue	nome masculino	qui|xi|li|[gan]|gue
quixiluanda	nome feminino	qui|xi|lu|[an]|da
quixipá	nome masculino	qui|xi|[pá]
quixó	nome masculino	qui|[xó]
quixobo	nome masculino	qui|[xo]|bo
quixotada	nome feminino	qui|xo|[ta]|da
quixote	nome masculino	qui|[xo]|te
quixotear	verbo	qui|xo|te|[ar]
quixotescamente	advérbio	qui|xo|tes|ca|[men]|te
quixotesco	adjetivo	qui|xo|[tes]|co
quixotice	nome feminino	qui|xo|[ti]|ce
quixótico	adjetivo	qui|[xó]|ti|co
quixotismo	nome masculino	qui|xo|[tis]|mo
quizaca	nome feminino	qui|[za]|ca
quizango	nome masculino	qui|[zan]|go
quizengo	nome masculino	qui|[zen]|go
quizila	nome masculino	qui|[zi]|la
quizila	nome feminino	qui|[zi]|la
quizilar	verbo	qui|zi|[lar]
quizilento	adjetivo	qui|zi|[len]|to
quizília	nome feminino	qui|[zí]|li|a
quizoco	nome masculino	qui|[zo]|co
quizomba	nome feminino	qui|[zom]|ba
quizomba	nome masculino	qui|[zom]|ba
quizúbi	nome masculino	qui|[zú]|bi
quizumba	nome feminino	qui|[zum]|ba
quizumbento	adjetivo	qui|zum|[ben]|to
quizunda	nome feminino	qui|[zun]|da
quizungrila	nome feminino	qui|zun|[gri]|la
quocientar	verbo	quo|ci|en|[tar]
quociente	nome masculino	quo|ci|[en]|te
quodlibetário	adjetivo	quo|dli|be|[tá]|ri|o
quodlibético	adjetivo	quo|dli|[bé]|ti|co
quodlibeto	nome masculino	quo|dli|[be]|to
quintanista	nome feminino	quin|ta|[nis]|ta
quintano	nome masculino	quin|[ta]|no
quintano	adjetivo	quin|[ta]|no
quintante	nome masculino	quin|[tan]|te
quintão	adjetivo	quin|[tão]
quintão	nome masculino	quin|[tão]
quintar	verbo	quin|[tar]
quintarola	nome feminino	quin|ta|[ro]|la
quinté	nome masculino	quin|[té]
quinteira	nome feminino	quin|[tei]|ra
quinteiro	nome masculino	quin|[tei]|ro
quintessencial	adjetivo	quin|tes|sen|ci|[al]
quinteto	nome masculino	quin|[te]|to
quinti	adjetivo	quin|[ti]
quintifalange	nome feminino	quin|ti|fa|[lan]|ge
quintifalangeta	nome feminino	quin|ti|fa|lan|[ge]|ta
quintifalanginha	nome feminino	quin|ti|fa|lan|[gi]|nha
quintil	adjetivo	quin|[til]
quintilha	nome feminino	quin|[ti]|lha
quintilhão	adjetivo	quin|ti|[lhão]
quintilhão	nome masculino	quin|ti|[lhão]
quintilianismo	nome masculino	quin|ti|li|a|[nis]|mo
quintiliano	adjetivo	quin|ti|li|[a]|no
quintilião	adjetivo	quin|ti|li|[ão]
quintilião	nome masculino	quin|ti|li|[ão]
quintílio	nome masculino	quin|[tí]|li|o
quintimetatársico	adjetivo	quin|ti|me|ta|[tár]|si|co
quintissecular	adjetivo	quin|tis|se|cu|[lar]
quinto	número ordinal	[quin]|to
quinto	número fraccional	[quin]|to
quinto	nome masculino	[quin]|to
quinto	adjetivo	[quin]|to
quintório	nome masculino	quin|[tó]|ri|o
quintupleta	nome feminino	quin|tu|[ple]|ta
quintuplicação	nome feminino	quin|tu|pli|ca|[ção]
quintuplicador	adjetivo	quin|tu|pli|ca|[dor]
quintuplicador	nome masculino	quin|tu|pli|ca|[dor]
quintuplicar	verbo	quin|tu|pli|[car]
quintuplicável	adjetivo	quin|tu|pli|[cá]|vel
quintuplinérveo	adjetivo	quin|tu|pli|[nér]|ve|o
quíntuplo	nome masculino	[quín]|tu|plo
quíntuplo	adjetivo	[quín]|tu|plo
quíntuplo	número multiplicativo	[quín]|tu|plo
quinzare	nome masculino	quin|[za]|re
quinze	nome masculino	[quin]|ze
quinze	número cardinal	[quin]|ze
quinze	adjetivo	[quin]|ze
quinzena	nome feminino	quin|[ze]|na
quinzenal	adjetivo	quin|ze|[nal]
quinzenalmente	advérbio	quin|ze|nal|[men]|te
quinzenário	nome masculino	quin|ze|[ná]|ri|o
quinzo	nome masculino	[quin]|zo
quinzol	nome masculino	quin|[zol]
quinzongo	nome masculino	quin|[zon]|go
quinzunguila	nome feminino	quin|zun|[gui]|la
quio	adjetivo	[qui]|o
quio	nome masculino	[qui]|o
quioca	nome feminino	qui|[o]|ca
quioco	adjetivo	qui|[o]|co
quioco	nome masculino	qui|[o]|co
quioiô	nome masculino	qui|oi|[ô]
quionococo	nome masculino	qui|o|no|[co]|co
quionólito	nome masculino	qui|o|[nó]|li|to
quionótomo	nome masculino	qui|o|[nó]|to|mo
quiosque	nome masculino	qui|[os]|que
quiosqueiro	nome masculino	qui|os|[quei]|ro
quipá	nome masculino	qui|[pá]
quipapá	nome masculino	qui|pa|[pá]
quipele	nome masculino	qui|[pe]|le
quipembe	nome masculino	qui|[pem]|be
quipico	nome masculino	qui|[pi]|co
quipo	nome masculino	[qui]|po
quipoqué	nome masculino	qui|po|[qué]
quipos	nome masculino	[qui]|pos
quiproquó	nome masculino	qui|pro|[quó]
quipuculo	nome masculino	qui|pu|[cu]|lo
quipululo	nome masculino	qui|pu|[lu]|lo
quipúndi	nome masculino	qui|[pún]|di
quipungo	adjetivo	qui|[pun]|go
quipungo	nome masculino	qui|[pun]|go
quipungulo	nome masculino	qui|pun|[gu]|lo
quiqueriqui	nome masculino	qui|que|ri|[qui]
quiquerismo	nome masculino	qui|que|[ris]|mo
quíquero	nome masculino	[quí]|que|ro
quiqui	nome masculino	qui|[qui]
quiquia	nome feminino	qui|[qui]|a
quiquiqui	nome masculino	qui|qui|[qui]
quirábi	nome masculino	qui|[rá]|bi
quiragra	nome feminino	qui|[ra]|gra
quiragra	adjetivo	qui|[ra]|gra
quiraita	nome feminino	qui|[rai]|ta
quiral	adjetivo	qui|[ral]
quiralgia	nome feminino	qui|ral|[gi]|a
quirálgico	adjetivo	qui|[rál]|gi|co
quiralidade	nome feminino	qui|ra|li|[da]|de
quirana	nome feminino	qui|[ra]|na
quiranto	nome masculino	qui|[ran]|to
quirate	nome masculino	qui|[ra]|te
quirato	nome masculino	qui|[ra]|to
quirche	nome masculino	[quir]|che
quinimura	nome masculino	qui|ni|[mu]|ra
quinimura	nome feminino	qui|ni|[mu]|ra
quinina	nome feminino	qui|[ni]|na
quinínico	adjetivo	qui|[ní]|ni|co
quininismo	nome masculino	qui|ni|[nis]|mo
quinino	nome masculino	qui|[ni]|no
quínio	nome masculino	[quí]|ni|o
quiniquinau	adjetivo	qui|ni|qui|[nau]
quiniquinau	nome masculino	qui|ni|qui|[nau]
quiniquinau	nome feminino	qui|ni|qui|[nau]
quinismo	nome masculino	qui|[nis]|mo
quino	nome masculino	[qui]|no
quinoa	nome feminino	qui|[no]|a
quinoleico	adjetivo	qui|no|[lei]|co
quinoleína	nome feminino	qui|no|le|[í]|na
quinologia	nome feminino	qui|no|lo|[gi]|a
quinológico	adjetivo	qui|no|[ló]|gi|co
quinólogo	nome masculino	qui|[nó]|lo|go
quinometria	nome feminino	qui|no|me|[tri]|a
quinométrico	adjetivo	qui|no|[mé]|tri|co
quinona	nome feminino	qui|[no]|na
quinor	nome masculino	qui|[nor]
quinovato	nome masculino	qui|no|[va]|to
quinóvico	adjetivo	qui|[nó]|vi|co
quinquagenária	nome feminino	quin|qua|ge|[ná]|ri|a
quinquagenário	adjetivo	quin|qua|ge|[ná]|ri|o
quinquagenário	nome masculino	quin|qua|ge|[ná]|ri|o
quinquagésima	nome feminino	quin|qua|[gé]|si|ma
quinquagésimo	adjetivo	quin|qua|[gé]|si|mo
quinquagésimo	nome masculino	quin|qua|[gé]|si|mo
quinquagésimo	número fraccional	quin|qua|[gé]|si|mo
quinquagésimo	número ordinal	quin|qua|[gé]|si|mo
quinqueangular	adjetivo	quin|que|an|gu|[lar]
quinquecapsular	adjetivo	quin|que|cap|su|[lar]
quinquecelular	adjetivo	quin|que|ce|lu|[lar]
quinquedentado	adjetivo	quin|que|den|[ta]|do
quinquedigitado	adjetivo	quin|que|di|gi|[ta]|do
quinquefido	adjetivo	quin|[que]|fi|do
quinquefoliado	adjetivo	quin|que|fo|li|[a]|do
quinquefólio	adjetivo	quin|que|[fó]|li|o
quinquegenciano	adjetivo	quin|que|gen|ci|[a]|no
quinquegenciano	nome masculino	quin|que|gen|ci|[a]|no
quinquelíngue	adjetivo	quin|que|[lín]|gue
quinquelobado	adjetivo	quin|que|lo|[ba]|do
quinquenal	adjetivo	quin|que|[nal]
quinquenal	nome masculino	quin|que|[nal]
quinquenalidade	nome feminino	quin|que|na|li|[da]|de
quinquenalmente	advérbio	quin|que|nal|[men]|te
quinquenário	adjetivo	quin|que|[ná]|ri|o
quinquenervado	adjetivo	quin|que|ner|[va]|do
quinquênio	nome masculino	quin|[quê]|ni|o
quinquénio	nome masculino	quin|[qué]|ni|o
quinquerreme	nome feminino	quin|quer|[re]|me
quinquessecular	adjetivo	quin|ques|se|cu|[lar]
quinquessilábico	adjetivo	quin|ques|si|[lá]|bi|co
quinquessílabo	adjetivo	quin|ques|[sí]|la|bo
quinquessílabo	nome masculino	quin|ques|[sí]|la|bo
quinquevalente	adjetivo	quin|que|va|[len]|te
quinquevalvar	adjetivo	quin|que|val|[var]
quinquevalve	adjetivo	quin|que|[val]|ve
quinquevalvulado	adjetivo	quin|que|val|vu|[la]|do
quinquevalvular	adjetivo	quin|que|val|vu|[lar]
quinquevirado	nome masculino	quin|que|vi|[ra]|do
quinqueviral	adjetivo	quin|que|vi|[ral]
quinquevirato	nome masculino	quin|que|vi|[ra]|to
quinquéviro	nome masculino	quin|[qué]|vi|ro
quinquídio	nome masculino	quin|[quí]|di|o
quinquíduo	nome masculino	quin|[quí]|du|o
quinquilátero	nome masculino	quin|qui|[lá]|te|ro
quinquilharia	nome feminino	quin|qui|lha|[ri]|a
quinquilheiro	nome masculino	quin|qui|[lhei]|ro
quinquina	nome feminino	quin|[qui]|na
quinquinado	adjetivo	quin|qui|[na]|do
quinquinado	nome masculino	quin|qui|[na]|do
quinquió	nome masculino	quin|qui|[ó]
quinta	nome feminino	[quin]|ta
quintã	nome feminino	quin|[tã]
quintã	adjetivo	quin|[tã]
quinta-coluna	nome feminino	quin|ta-co|[lu]|na
quinta-colunismo	nome masculino	quin|ta-co|lu|[nis]|mo
quinta-colunista	nome feminino	quin|ta-co|lu|[nis]|ta
quinta-colunista	nome masculino	quin|ta-co|lu|[nis]|ta
quinta-colunista	adjetivo	quin|ta-co|lu|[nis]|ta
quinta-essência	nome feminino	quin|ta-es|[sên]|ci|a
quinta-essencial	adjetivo	quin|ta-es|sen|ci|[al]
quinta-feira	nome feminino	quin|ta-fei|ra
quinta-substância	nome feminino	quin|ta-subs|[tân]|ci|a
quintadajila	nome feminino	quin|ta|da|[ji]|la
quintadecimano	nome masculino	quin|ta|de|ci|[ma]|no
quintador	adjetivo	quin|ta|[dor]
quintador	nome masculino	quin|ta|[dor]
quintal	nome masculino	quin|[tal]
quintalada	nome feminino	quin|ta|[la]|da
quintalão	nome masculino	quin|ta|[lão]
quintaleiro	nome masculino	quin|ta|[lei]|ro
quintalejo	nome masculino	quin|ta|[le]|jo
quintalório	nome masculino	quin|ta|[ló]|ri|o
quintaneiro	nome masculino	quin|ta|[nei]|ro
quintanista	nome masculino	quin|ta|[nis]|ta
quintanista	adjetivo	quin|ta|[nis]|ta
quaternização	nome feminino	qua|ter|ni|za|[ção]
quaternizar	verbo	qua|ter|ni|[zar]
quaterno	adjetivo	qua|[ter]|no
quaterno	nome masculino	qua|[ter]|no
quati	nome masculino	qua|[ti]
quatiara	nome feminino	qua|ti|[a]|ra
quatibo	nome masculino	qua|[ti]|bo
quatimirim	nome masculino	qua|ti|mi|[rim]
quatimundé	nome masculino	qua|ti|mun|[dé]
quatindiba	nome feminino	qua|tin|[di]|ba
quatipuru	nome masculino	qua|ti|pu|[ru]
quatorzada	nome feminino	qua|tor|[za]|da
quatorze	adjetivo	qua|[tor]|ze
quatorze	número cardinal	qua|[tor]|ze
quatorze	nome masculino	qua|[tor]|ze
quatorzeno	nome masculino	qua|tor|[ze]|no
quatralvo	adjetivo	qua|[tral]|vo
quatranha	nome feminino	qua|[tra]|nha
quatrela	nome feminino	qua|[tre]|la
quatriduano	adjetivo	qua|tri|du|[a]|no
quatríduo	nome masculino	qua|[trí]|du|o
quatrienal	adjetivo	qua|tri|e|[nal]
quatriênio	nome masculino	qua|tri|[ê]|ni|o
quatriénio	nome masculino	qua|tri|[é]|ni|o
quatrilhão	nome masculino	qua|tri|[lhão]
quatrilhão	adjetivo	qua|tri|[lhão]
quatrilião	adjetivo	qua|tri|li|[ão]
quatrilião	nome masculino	qua|tri|li|[ão]
quatrim	nome masculino	qua|[trim]
quatrinca	nome feminino	qua|[trin]|ca
quatrineta	nome feminino	qua|tri|[ne]|ta
quatro	nome masculino	[qua]|tro
quatro	adjetivo	[qua]|tro
quatro	número cardinal	[qua]|tro
quatro-cantinhos	nome masculino	qua|tro-can|[ti]|nhos
quatro-cantos	nome masculino	qua|tro-can|tos
quatro-olhos	nome masculino	qua|tro-o|lhos
quatro-olhos	nome feminino	qua|tro-o|lhos
quatro-patacas	nome feminino	qua|tro-pa|[ta]|cas
quatro-reis	nome masculino	qua|tro-reis
quatrocentismo	nome masculino	qua|tro|cen|[tis]|mo
quatrocentista	nome masculino	qua|tro|cen|[tis]|ta
quatrocentista	adjetivo	qua|tro|cen|[tis]|ta
quatrocentista	nome feminino	qua|tro|cen|[tis]|ta
quatrocentos	número cardinal	qua|tro|[cen]|tos
quatrocentos	adjetivo	qua|tro|[cen]|tos
quatrocentos	nome masculino	qua|tro|[cen]|tos
quatrolho	adjetivo	qua|[tro]|lho
quatuorvirado	nome masculino	qua|tu|or|vi|[ra]|do
quatuorviral	adjetivo	qua|tu|or|vi|[ral]
quatuorvirato	nome masculino	qua|tu|or|vi|[ra]|to
quatuórviro	nome masculino	qua|tu|[ór]|vi|ro
quaxinduba	nome feminino	qua|xin|[du]|ba
quaxinguba	nome feminino	qua|xin|[gu]|ba
que	pronome relativo	que
quê	nome masculino	[quê]
que	conjunção	que
que	advérbio	[que]
quê	pronome interrogativo	[quê]
que	pronome interrogativo	que
que	artigo interrogativo	que
quê	interjeição	[quê]
quê	pronome relativo	[quê]
que-farte	advérbio	que-far|te
quê-u	nome masculino	[quê-u]
queba	adjetivo	[que]|ba
quebequense	adjetivo	que|be|[quen]|se
quebequense	nome masculino	que|be|[quen]|se
quebequense	nome feminino	que|be|[quen]|se
quebra	adjetivo	[que]|bra
quebra	nome masculino	[que]|bra
quebra	nome feminino	[que]|bra
quebra-bunda	nome masculino	que|bra-bun|da
quebra-cabeça	nome masculino	que|bra-ca|[be]|ça
quebra-cabeças	nome masculino	que|bra-ca|[be]|ças
quebra-cana	nome feminino	que|bra-ca|na
quebra-cangalhas	nome masculino	que|bra-can|[ga]|lhas
quebra-costas	nome masculino	que|bra-cos|tas
quebra-costelas	nome masculino	que|bra-cos|[te]|las
quebra-enguiço	nome masculino	que|bra-en|[gui]|ço
quebra-esquinas	nome masculino	que|bra-es|[qui]|nas
quebra-foice	nome masculino	que|bra-foi|ce
quebra-freio	nome masculino	que|bra-frei|o
quebra-freio	adjetivo	que|bra-frei|o
quebra-galho	nome masculino	que|bra-ga|lho
quebra-gelo	nome masculino	que|bra-ge|lo
quebra-jejum	nome masculino	que|bra-je|[jum]
quebra-largado	nome masculino	que|bra-lar|[ga]|do
quebra-louças	nome masculino	que|bra-lou|ças
quebra-luz	nome masculino	que|bra-luz
quebra-machado	nome masculino	que|bra-ma|[cha]|do
quebra-mar	nome masculino	que|bra-mar
quebra-nozes	nome masculino	que|bra-no|zes
quebra-panela	nome feminino	que|bra-pa|[ne]|la
quebra-panelas	nome feminino	que|bra-pa|[ne]|las
quebra-panelas	nome masculino	que|bra-pa|[ne]|las
quebra-pedra	nome feminino	que|bra-pe|dra
quebra-queixo	nome masculino	que|bra-quei|xo
quebra-quilos	nome masculino	que|bra-qui|los
quebração	nome feminino	que|bra|[ção]
quacacuja	nome masculino	qua|ca|[cu]|ja
quacre	nome masculino	[qua]|cre
quacriano	adjetivo	qua|cri|[a]|no
quacrismo	nome masculino	qua|[cris]|mo
quaderna	nome feminino	qua|[der]|na
quadernado	adjetivo	qua|der|[na]|do
quadernal	nome masculino	qua|der|[nal]
quado	adjetivo	[qua]|do
quado	nome masculino	[qua]|do
quadra	nome feminino	[qua]|dra
quadraçal	nome masculino	qua|dra|[çal]
quadrada	nome feminino	qua|[dra]|da
quadradinho	nome masculino	qua|dra|[di]|nho
quadradito	nome masculino	qua|dra|[di]|to
quadrado	adjetivo	qua|[dra]|do
quadrado	nome masculino	qua|[dra]|do
quadrador	adjetivo	qua|dra|[dor]
quadrador	nome masculino	qua|dra|[dor]
quadradozinho	nome masculino	qua|dra|do|[zi]|nho
quadradozito	nome masculino	qua|dra|do|[zi]|to
quadradura	nome feminino	qua|dra|[du]|ra
quadragenária	nome feminino	qua|dra|ge|[ná]|ri|a
quadragenário	adjetivo	qua|dra|ge|[ná]|ri|o
quadragenário	nome masculino	qua|dra|ge|[ná]|ri|o
quadragésima	nome feminino	qua|dra|[gé]|si|ma
quadragesimal	adjetivo	qua|dra|ge|si|[mal]
quadragésimo	adjetivo	qua|dra|[gé]|si|mo
quadragésimo	número ordinal	qua|dra|[gé]|si|mo
quadragésimo	nome masculino	qua|dra|[gé]|si|mo
quadragésimo	número fraccional	qua|dra|[gé]|si|mo
quadrangulação	nome feminino	qua|dran|gu|la|[ção]
quadrangulado	adjetivo	qua|dran|gu|[la]|do
quadrangular	nome masculino	qua|dran|gu|[lar]
quadrangular	adjetivo	qua|dran|gu|[lar]
quadrangularmente	advérbio	qua|dran|gu|lar|[men]|te
quadrângulo	nome masculino	qua|[drân]|gu|lo
quadrantal	adjetivo	qua|dran|[tal]
quadrantal	nome masculino	qua|dran|[tal]
quadrante	nome masculino	qua|[dran]|te
quadrar	verbo	qua|[drar]
quadrático	adjetivo	qua|[drá]|ti|co
quadratífero	adjetivo	qua|dra|[tí]|fe|ro
quadratim	nome masculino	qua|dra|[tim]
quadratriz	nome feminino	qua|dra|[triz]
quadratura	nome feminino	qua|dra|[tu]|ra
quadraturista	nome masculino	qua|dra|tu|[ris]|ta
quadraturista	nome feminino	qua|dra|tu|[ris]|ta
quadrável	adjetivo	qua|[drá]|vel
quadrazenho	adjetivo	qua|dra|[ze]|nho
quadrazenho	nome masculino	qua|dra|[ze]|nho
quadrela	nome feminino	qua|[dre]|la
quadrelo	nome masculino	qua|[dre]|lo
quadrialado	adjetivo	qua|dri|a|[la]|do
quadriângulo	nome masculino	qua|dri|[ân]|gu|lo
quadribásico	adjetivo	qua|dri|[bá]|si|co
quadriburgense	nome masculino	qua|dri|bur|[gen]|se
quadriburgense	adjetivo	qua|dri|bur|[gen]|se
quadriburgense	nome feminino	qua|dri|bur|[gen]|se
quadribúrgio	adjetivo	qua|dri|[búr]|gi|o
quadribúrgio	nome masculino	qua|dri|[búr]|gi|o
quádrica	nome feminino	[quá]|dri|ca
quadricapsular	adjetivo	qua|dri|cap|su|[lar]
quadricarboneto	nome masculino	qua|dri|car|bo|[ne]|to
quadricelular	adjetivo	qua|dri|ce|lu|[lar]
quadricentenário	nome masculino	qua|dri|cen|te|[ná]|ri|o
quadricêntrico	adjetivo	qua|dri|[cên]|tri|co
quadríceps	nome masculino	qua|[drí]|ceps
quadriciclo	nome masculino	qua|dri|[ci]|clo
quadriciclo	adjetivo	qua|dri|[ci]|clo
quadricipital	adjetivo	qua|dri|ci|pi|[tal]
quadricípite	nome masculino	qua|dri|[cí]|pi|te
quadricolor	adjetivo	qua|dri|co|[lor]
quadricórneo	adjetivo	qua|dri|[cór]|ne|o
quadricotiledôneo	adjetivo	qua|dri|co|ti|le|[dô]|ne|o
quadricotiledóneo	adjetivo	qua|dri|co|ti|le|[dó]|ne|o
quadricromia	nome feminino	qua|dri|cro|[mi]|a
quadrícula	nome feminino	qua|[drí]|cu|la
quadriculado	adjetivo	qua|dri|cu|[la]|do
quadriculado	nome masculino	qua|dri|cu|[la]|do
quadricular	verbo	qua|dri|cu|[lar]
quadricular	adjetivo	qua|dri|cu|[lar]
quadrículo	nome masculino	qua|[drí]|cu|lo
quadricúspide	adjetivo	qua|dri|[cús]|pi|de
quadridecimal	adjetivo	qua|dri|de|ci|[mal]
quadridentado	adjetivo	qua|dri|den|[ta]|do
quadridente	nome masculino	qua|dri|[den]|te
quadridigitado	adjetivo	qua|dri|di|gi|[ta]|do
quadrienal	adjetivo	qua|dri|e|[nal]
quadrienalmente	advérbio	qua|dri|e|nal|[men]|te
quadriénio	nome masculino	qua|dri|[é]|ni|o
quadriênio	nome masculino	qua|dri|[ê]|ni|o
quadriexagonal	adjetivo	qua|dri|e|xa|go|[nal]
quadrifário	adjetivo	qua|dri|[fá]|ri|o
quadrifendido	adjetivo	qua|dri|fen|[di]|do
quadrífido	adjetivo	qua|[drí]|fi|do
quadrifínio	nome masculino	qua|dri|[fí]|ni|o
quadriflóreo	adjetivo	qua|dri|[fló]|re|o
quadrifloro	adjetivo	qua|dri|[flo]|ro
quadrifoliado	adjetivo	qua|dri|fo|li|[a]|do
quadrifólio	nome masculino	qua|dri|[fó]|li|o
quadrifólio	adjetivo	qua|dri|[fó]|li|o
quadrifonia	nome feminino	qua|dri|fo|[ni]|a
quadriforcado	adjetivo	qua|dri|for|[ca]|do
quadriforme	adjetivo	qua|dri|[for]|me
quadrifronte	adjetivo	qua|dri|[fron]|te
quadrifurcado	adjetivo	qua|dri|fur|[ca]|do
quadriga	nome feminino	qua|[dri]|ga
quadrigário	nome masculino	qua|dri|[gá]|ri|o
quadrigémea	nome feminino	qua|dri|[gé]|me|a
quadrigêmeo	adjetivo	qua|dri|[gê]|me|o
quadrigêmeo	nome masculino	qua|dri|[gê]|me|o
quadrigémeo	adjetivo	qua|dri|[gé]|me|o
quadrigémeo	nome masculino	qua|dri|[gé]|me|o
quadrigeminado	adjetivo	qua|dri|ge|mi|[na]|do
quadrigêmino	adjetivo	qua|dri|[gê]|mi|no
quadrigémino	adjetivo	qua|dri|[gé]|mi|no
quadrigitado	adjetivo	qua|dri|gi|[ta]|do
quadrigúmeo	adjetivo	qua|dri|[gú]|me|o
quadrijugado	adjetivo	qua|dri|ju|[ga]|do
quadríjugo	adjetivo	qua|[drí]|ju|go
quadril	nome masculino	qua|[dril]
quadrilateral	adjetivo	qua|dri|la|te|[ral]
quadrilátero	nome masculino	qua|dri|[lá]|te|ro
quadrilátero	adjetivo	qua|dri|[lá]|te|ro
quadrilha	nome feminino	qua|[dri]|lha
quadrilha	nome masculino	qua|[dri]|lha
quadrilhado	adjetivo	qua|dri|[lha]|do
quadrilhar	verbo	qua|dri|[lhar]
quadrilheira	nome feminino	qua|dri|[lhei]|ra
quadrilheiro	nome masculino	qua|dri|[lhei]|ro
quadrilheiro	adjetivo	qua|dri|[lhei]|ro
quadrilítero	adjetivo	qua|dri|[lí]|te|ro
quadrilobado	adjetivo	qua|dri|lo|[ba]|do
quadrilobulado	adjetivo	qua|dri|lo|bu|[la]|do
quadrilóbulo	nome masculino	qua|dri|[ló]|bu|lo
quadriloculado	adjetivo	qua|dri|lo|cu|[la]|do
quadrilocular	adjetivo	qua|dri|lo|cu|[lar]
quadrilongo	adjetivo	qua|dri|[lon]|go
quadrilongo	nome masculino	qua|dri|[lon]|go
quadrilunulado	adjetivo	qua|dri|lu|nu|[la]|do
quadrimaculado	adjetivo	qua|dri|ma|cu|[la]|do
quadrímano	nome masculino	qua|[drí]|ma|no
quadrímano	adjetivo	qua|[drí]|ma|no
quadrimembre	adjetivo	qua|dri|[mem]|bre
quadrimestral	adjetivo	qua|dri|mes|[tral]
quadrimestralmente	advérbio	qua|dri|mes|tral|[men]|te
quadrimestre	nome masculino	qua|dri|[mes]|tre
quadrimosqueado	adjetivo	qua|dri|mos|que|[a]|do
quadrimotor	nome masculino	qua|dri|mo|[tor]
quadrimotor	adjetivo	qua|dri|mo|[tor]
quadringentenário	nome masculino	qua|drin|gen|te|[ná]|ri|o
quadringentésimo	nome masculino	qua|drin|gen|[té]|si|mo
quadringentésimo	número fraccional	qua|drin|gen|[té]|si|mo
quadringentésimo	adjetivo	qua|drin|gen|[té]|si|mo
quadringentésimo	número ordinal	qua|drin|gen|[té]|si|mo
quadrinômio	nome masculino	qua|dri|[nô]|mi|o
quadrinómio	nome masculino	qua|dri|[nó]|mi|o
quadrioctonal	adjetivo	qua|dri|oc|to|[nal]
quadripartição	nome feminino	qua|dri|par|ti|[ção]
quadripartido	adjetivo	qua|dri|par|[ti]|do
quadripartito	adjetivo	qua|dri|par|[ti]|to
quadripenado	adjetivo	qua|dri|pe|[na]|do
quadripene	adjetivo	qua|dri|[pe]|ne
quadripétalo	adjetivo	qua|dri|[pé]|ta|lo
quadriplegia	nome feminino	qua|dri|ple|[gi]|a
quadriplégica	nome feminino	qua|dri|[plé]|gi|ca
quadriplégico	adjetivo	qua|dri|[plé]|gi|co
quadriplégico	nome masculino	qua|dri|[plé]|gi|co
quadripolar	adjetivo	qua|dri|po|[lar]
quadripolo	nome masculino	qua|dri|[po]|lo
quadrirreator	adjetivo	qua|drir|re|a|[tor]
quadrirreator	nome masculino	qua|drir|re|a|[tor]
quadrirreme	nome feminino	qua|drir|[re]|me
quadrirreme	adjetivo	qua|drir|[re]|me
quadrissecular	adjetivo	qua|dris|se|cu|[lar]
quadrisseriado	adjetivo	qua|dris|se|ri|[a]|do
quadrisseriado	nome masculino	qua|dris|se|ri|[a]|do
quadrissilábico	adjetivo	qua|dris|si|[lá]|bi|co
quadrissílabo	adjetivo	qua|dris|[sí]|la|bo
quadrissílabo	nome masculino	qua|dris|[sí]|la|bo
quadrissulco	adjetivo	qua|dris|[sul]|co
quadrivalência	nome feminino	qua|dri|va|[lên]|ci|a
quadrivalente	adjetivo	qua|dri|va|[len]|te
quadrivalve	adjetivo	qua|dri|[val]|ve
quadrivalvulado	adjetivo	qua|dri|val|vu|[la]|do
quadrivalvular	adjetivo	qua|dri|val|vu|[lar]
quadrívio	nome masculino	qua|[drí]|vi|o
quadro	nome masculino	[qua]|dro
quadro-de-calçar	nome masculino	qua|dro-de-cal|[çar]
quádrobro	nome masculino	[quá]|dro|bro
quadrúmano	nome masculino	qua|[drú]|ma|no
quadrúmano	adjetivo	qua|[drú]|ma|no
quadrunvirado	nome masculino	qua|drun|vi|[ra]|do
quadrunviral	adjetivo	qua|drun|vi|[ral]
quadrunvirato	nome masculino	qua|drun|vi|[ra]|to
quadrúnviro	nome masculino	qua|[drún]|vi|ro
quadrupedante	adjetivo	qua|dru|pe|[dan]|te
quadrupedante	nome masculino	qua|dru|pe|[dan]|te
quadrupedar	verbo	qua|dru|pe|[dar]
quadrúpede	nome masculino	qua|[drú]|pe|de
quodore	nome masculino	quo|[do]|re
quodório	nome masculino	quo|[dó]|ri|o
quoro	nome masculino	[quo]|ro
quórum	nome masculino	[quó]|rum
quota	nome feminino	[quo]|ta
quota-parte	nome feminino	quo|ta-par|te
quotidade	nome feminino	quo|ti|[da]|de
quotidianamente	advérbio	quo|ti|di|a|na|[men]|te
quotidianidade	nome feminino	quo|ti|di|a|ni|[da]|de
quotidianizar	verbo	quo|ti|di|a|ni|[zar]
quotidiano	adjetivo	quo|ti|di|[a]|no
quotidiano	nome masculino	quo|ti|di|[a]|no
quotiliquê	nome masculino	quo|ti|li|[quê]
quotista	nome masculino	quo|[tis]|ta
quotista	adjetivo	quo|[tis]|ta
quotização	nome feminino	quo|ti|za|[ção]
quotizante	adjetivo	quo|ti|[zan]|te
quotizante	nome masculino	quo|ti|[zan]|te
quotizante	nome feminino	quo|ti|[zan]|te
quotizar	verbo	quo|ti|[zar]
quotizável	adjetivo	quo|ti|[zá]|vel
quietura	nome feminino	qui|e|[tu]|ra
quifaça	nome feminino	qui|[fa]|ça
quifacoto	nome masculino	qui|fa|[co]|to
quifoce	nome masculino	qui|[fo]|ce
quifuça	adjetivo	qui|[fu]|ça
quifuco	nome masculino	qui|[fu]|co
quifufutila	nome feminino	qui|fu|fu|[ti]|la
quifuje	nome masculino	qui|[fu]|je
quifula	nome feminino	qui|[fu]|la
quifumbe	nome masculino	qui|[fum]|be
quifunate	nome masculino	qui|fu|[na]|te
quifuxo	nome masculino	qui|[fu]|xo
quigombô	nome masculino	qui|gom|[bô]
quijila	nome feminino	qui|[ji]|la
quijilar	verbo	qui|ji|[lar]
quijinga	nome feminino	qui|[jin]|ga
quijuba	nome masculino	qui|[ju]|ba
quilacatembo	nome masculino	qui|la|ca|[tem]|bo
quilalgia	nome feminino	qui|lal|[gi]|a
quilálgico	adjetivo	qui|[lál]|gi|co
quilamba	nome masculino	qui|[lam]|ba
quilambalambe	nome masculino	qui|lam|ba|[lam]|be
quilando	nome masculino	qui|[lan]|do
quilapanga	nome feminino	qui|la|[pan]|ga
quilápi	nome masculino	qui|[lá]|pi
quilatação	nome feminino	qui|la|ta|[ção]
quilatador	nome masculino	qui|la|ta|[dor]
quilatar	verbo	qui|la|[tar]
quilate	nome masculino	qui|[la]|te
quilateira	nome feminino	qui|la|[tei]|ra
quileba	adjetivo	qui|[le]|ba
quileba	nome masculino	qui|[le]|ba
quileba	nome feminino	qui|[le]|ba
quilembe	nome masculino	qui|[lem]|be
quilengolengo	nome masculino	qui|len|go|[len]|go
quilha	nome feminino	[qui]|lha
quilhar	verbo	qui|[lhar]
quilhar	adjetivo	qui|[lhar]
quilhar	nome masculino	qui|[lhar]
quilhoto	nome masculino	qui|[lho]|to
quili	nome masculino	qui|[li]
quili-culu	adjetivo	qui|li-cu|[lu]
quilíada	nome feminino	qui|[lí]|a|da
quilíade	nome feminino	qui|[lí]|a|de
quiliarco	nome masculino	qui|li|[ar]|co
quiliare	nome masculino	qui|li|[a]|re
quiliarquia	nome feminino	qui|li|ar|[qui]|a
quiliárquico	adjetivo	qui|li|[ár]|qui|co
quiliasta	adjetivo	qui|li|[as]|ta
quiliasta	nome masculino	qui|li|[as]|ta
quiliasta	nome feminino	qui|li|[as]|ta
quilífero	adjetivo	qui|[lí]|fe|ro
quilificação	nome feminino	qui|li|fi|ca|[ção]
quilificar	verbo	qui|li|fi|[car]
quilificativo	adjetivo	qui|li|fi|ca|[ti]|vo
quiliógono	nome masculino	qui|li|[ó]|go|no
quilite	nome feminino	qui|[li]|te
quilo	nome masculino	[qui]|lo
quiloamba	nome masculino	qui|lo|[am]|ba
quiloampere	nome masculino	qui|lo|am|[pe]|re
quilobit	nome masculino	qui|[lo]|bit
quilobyte	nome masculino	qui|lo|[by]|te
quilocaloria	nome feminino	qui|lo|ca|lo|[ri]|a
quilociclo	nome masculino	qui|lo|[ci]|clo
quilocoulomb	nome masculino	qui|lo|cou|[lomb]
quilocuenque	nome masculino	qui|lo|cu|[en]|que
quilodieresia	nome feminino	qui|lo|di|e|re|[si]|a
quilofagia	nome feminino	qui|lo|fa|[gi]|a
quilofilia	nome feminino	qui|lo|fi|[li]|a
quilóforo	adjetivo	qui|[ló]|fo|ro
quilógnato	nome masculino	qui|[lóg]|na|to
quilógnato	adjetivo	qui|[lóg]|na|to
quilograma	nome masculino	qui|lo|[gra]|ma
quilograma-força	nome masculino	qui|lo|gra|ma-for|ça
quilograma-padrão	nome masculino	qui|lo|gra|ma-pa|[drão]
quilograma-peso	nome masculino	qui|lo|gra|ma-pe|so
quilogrâmetro	nome masculino	qui|lo|[grâ]|me|tro
quilohertz	nome masculino	qui|lo|[hertz]
quilojoule	nome masculino	qui|lo|[jou]|le
quilojúlio	nome masculino	qui|lo|[jú]|li|o
quilolitro	nome masculino	qui|lo|[li]|tro
quilolo	nome masculino	qui|[lo]|lo
quilologia	nome feminino	qui|lo|lo|[gi]|a
quilológico	adjetivo	qui|lo|[ló]|gi|co
quilombo	nome masculino	qui|[lom]|bo
quilombola	nome masculino	qui|lom|[bo]|la
quilombola	nome feminino	qui|lom|[bo]|la
quilometragem	nome feminino	qui|lo|me|[tra]|gem
quilometrar	verbo	qui|lo|me|[trar]
quilometricamente	advérbio	qui|lo|me|tri|ca|[men]|te
quilométrico	adjetivo	qui|lo|[mé]|tri|co
quilómetro	nome masculino	qui|[ló]|me|tro
quilômetro	nome masculino	qui|[lô]|me|tro
quiloparsec	nome masculino	qui|lo|[par]|sec
quiloplastia	nome feminino	qui|lo|plas|[ti]|a
quiloplástico	adjetivo	qui|lo|[plás]|ti|co
quilópode	nome masculino	qui|[ló]|po|de
quilópode	adjetivo	qui|[ló]|po|de
quilopoese	nome feminino	qui|lo|po|[e]|se
quilose	nome feminino	qui|[lo]|se
quibire	nome masculino	qui|[bi]|re
quiboça	nome feminino	qui|[bo]|ça
quibolobolo	nome masculino	qui|bo|lo|[bo]|lo
quibondo	nome masculino	qui|[bon]|do
quibóri	nome masculino	qui|[bó]|ri
quíbua	nome feminino	[quí]|bu|a
quibuca	nome feminino	qui|[bu]|ca
quibuiquila	nome feminino	qui|bui|[qui]|la
quibumbo	nome masculino	qui|[bum]|bo
quibungo	nome masculino	qui|[bun]|go
quibuquila	nome feminino	qui|bu|[qui]|la
quibuto	nome masculino	qui|[bu]|to
quibuzo	nome masculino	qui|[bu]|zo
quiçá	advérbio	qui|[çá]
quiçaba	nome feminino	qui|[ça]|ba
quiçaça	nome feminino	qui|[ça]|ça
quicada	nome feminino	qui|[ca]|da
quiçafu	nome masculino	qui|ça|[fu]
quiçais	advérbio	qui|[çais]
quiçama	adjetivo	qui|[ça]|ma
quiçama	nome masculino	qui|[ça]|ma
quiçama	nome feminino	qui|[ça]|ma
quiçamba	nome masculino	qui|[çam]|ba
quiçameiro	nome masculino	qui|ça|[mei]|ro
quiçandambunje	nome masculino	qui|çan|dam|[bun]|je
quiçângua	nome feminino	qui|[çân]|gua
quiçanja	nome feminino	qui|[çan]|ja
quiçapo	nome masculino	qui|[ça]|po
quiçau	nome masculino	qui|[çau]
quicé	nome masculino	qui|[cé]
quicê	nome masculino	qui|[cê]
quicé	nome feminino	qui|[cé]
quiceacica	nome masculino	qui|ce|a|[ci]|ca
quiceco	nome masculino	qui|[ce]|co
quicécua	nome feminino	qui|[cé]|cu|a
quicema	nome feminino	qui|[ce]|ma
quicengo	nome masculino	qui|[cen]|go
quichaça	nome feminino	qui|[cha]|ça
quiche	nome masculino	[qui]|che
quiche	nome feminino	[qui]|che
quíchua	nome masculino	[quí]|chu|a
quíchua	adjetivo	[quí]|chu|a
quíchua	nome feminino	[quí]|chu|a
quício	nome masculino	[quí]|ci|o
quiço	nome masculino	[qui]|ço
quico	nome masculino	[qui]|co
quicobequelababa	nome feminino	qui|co|be|que|la|[ba]|ba
quiçocolaloa	nome feminino	qui|ço|co|la|[lo]|a
quicocomela	nome feminino	qui|co|co|[me]|la
quiçoçoria	nome feminino	qui|ço|ço|[ri]|a
quicócua	nome feminino	qui|[có]|cu|a
quícola	adjetivo	[quí]|co|la
quicole	nome masculino	qui|[co]|le
quiçonda	nome feminino	qui|[çon]|da
quiçonde	nome masculino	qui|[çon]|de
quicongo	nome masculino	qui|[con]|go
quicongo	adjetivo	qui|[con]|go
quicongo	nome feminino	qui|[con]|go
quiconha	nome feminino	qui|[co]|nha
quícua	nome feminino	[quí]|cu|a
quicuacula	nome feminino	qui|cu|a|[cu]|la
quiçuaíle	nome masculino	qui|çu|a|[í]|le
quicuala	nome feminino	qui|cu|[a]|la
quicuamanga	nome feminino	qui|cu|a|[man]|ga
quicuambe	nome masculino	qui|cu|[am]|be
quicuandiata	nome feminino	qui|cu|an|di|[a]|ta
quicuanga	nome feminino	qui|cu|[an]|ga
quicuanga	nome masculino	qui|cu|[an]|ga
quicuerra	nome masculino	qui|cu|[er]|ra
quicuio	nome masculino	qui|[cui]|o
quicuio	adjetivo	qui|[cui]|o
quicuio	nome feminino	qui|[cui]|o
quicumba	nome feminino	qui|[cum]|ba
quicúmbi	nome masculino	qui|[cúm]|bi
quicundo	nome masculino	qui|[cun]|do
quicungo	nome masculino	qui|[cun]|go
quicuta	nome feminino	qui|[cu]|ta
quidalê	interjeição	qui|da|[lê]
quididade	nome feminino	qui|di|[da]|de
quididativo	adjetivo	qui|di|da|[ti]|vo
quidingo	nome masculino	qui|[din]|go
quiê-quiê	nome masculino	qui|ê-qui|[ê]
quieira	nome feminino	qui|[ei]|ra
quiela	nome feminino	qui|[e]|la
quienza	nome feminino	qui|[en]|za
quienze	nome masculino	qui|[en]|ze
quiescente	adjetivo	qui|es|[cen]|te
quietação	nome feminino	qui|e|ta|[ção]
quietamente	advérbio	qui|e|ta|[men]|te
quietar	verbo	qui|e|[tar]
quietarrão	nome masculino	qui|e|tar|[rão]
quietarrão	adjetivo	qui|e|tar|[rão]
quiete	nome feminino	qui|[e]|te
quietismo	nome masculino	qui|e|[tis]|mo
quietista	nome masculino	qui|e|[tis]|ta
quietista	nome feminino	qui|e|[tis]|ta
quieto	adjetivo	qui|[e]|to
quieto	nome masculino	qui|[e]|to
quietole	nome masculino	qui|e|[to]|le
quietude	nome feminino	qui|e|[tu]|de
quimitípico	adjetivo	qui|mi|[tí]|pi|co
quimo	nome masculino	[qui]|mo
quimografia	nome feminino	qui|mo|gra|[fi]|a
quimográfico	adjetivo	qui|mo|[grá]|fi|co
quimógrafo	nome masculino	qui|[mó]|gra|fo
quimograma	nome masculino	qui|mo|[gra]|ma
quimonanto	nome masculino	qui|mo|[nan]|to
quimone	nome masculino	qui|[mo]|ne
quimono	nome masculino	qui|[mo]|no
quimonofobia	nome feminino	qui|mo|no|fo|[bi]|a
quimonófobo	adjetivo	qui|mo|[nó]|fo|bo
quimonófobo	nome masculino	qui|mo|[nó]|fo|bo
quimose	nome feminino	qui|[mo]|se
quimosina	nome feminino	qui|mo|[si]|na
quimoso	adjetivo	qui|[mo]|so
quimpurula	nome feminino	quim|pu|[ru]|la
quimuanamuana	nome feminino	qui|mu|a|na|mu|[a]|na
quimuâni	nome masculino	qui|mu|[â]|ni
quimuxoco	nome masculino	qui|mu|[xo]|co
quina	nome feminino	[qui]|na
quiná	nome masculino	qui|[ná]
quinado	adjetivo	qui|[na]|do
quinama	nome feminino	qui|[na]|ma
quinamina	nome feminino	qui|na|[mi]|na
quinangabundo	nome masculino	qui|nan|ga|[bun]|do
quinante	adjetivo	qui|[nan]|te
quinaquina	nome feminino	qui|na|[qui]|na
quinar	verbo	qui|[nar]
quinário	adjetivo	qui|[ná]|ri|o
quinário	nome masculino	qui|[ná]|ri|o
quinato	nome masculino	qui|[na]|to
quinau	nome masculino	qui|[nau]
quincaju	nome masculino	quin|ca|[ju]
quincalha	nome feminino	quin|[ca]|lha
quincálogo	nome masculino	quin|[cá]|lo|go
quincha	nome feminino	[quin]|cha
quinchador	nome masculino	quin|cha|[dor]
quinchar	verbo	quin|[char]
quinchorro	nome masculino	quin|[chor]|ro
quinchoso	nome masculino	quin|[cho]|so
quincôncio	nome masculino	quin|[côn]|ci|o
quincunce	nome masculino	quin|[cun]|ce
quincuncial	adjetivo	quin|cun|ci|[al]
quincusse	nome masculino	quin|[cus]|se
quincússis	nome masculino	quin|[cús]|sis
quinda	nome feminino	[quin]|da
quindecágono	nome masculino	quin|de|[cá]|go|no
quindecenvirado	nome masculino	quin|de|cen|vi|[ra]|do
quindecenviral	adjetivo	quin|de|cen|vi|[ral]
quindecenvirato	nome masculino	quin|de|cen|vi|[ra]|to
quindecênviro	nome masculino	quin|de|[cên]|vi|ro
quindecioctonal	adjetivo	quin|de|ci|oc|to|[nal]
quindénio	nome masculino	quin|[dé]|ni|o
quindênio	nome masculino	quin|[dê]|ni|o
quindim	nome masculino	quin|[dim]
quindumba	nome feminino	quin|[dum]|ba
quinecu	nome masculino	qui|ne|[cu]
quineira	nome feminino	qui|[nei]|ra
quineiro	adjetivo	qui|[nei]|ro
quineiro	nome masculino	qui|[nei]|ro
quinesioterapia	nome feminino	qui|ne|si|o|te|ra|[pi]|a
quingandé	nome masculino	quin|gan|[dé]
quingentaria	nome feminino	quin|gen|ta|[ri]|a
quingentário	nome masculino	quin|gen|[tá]|ri|o
quingentenário	nome masculino	quin|gen|te|[ná]|ri|o
quingentésimo	número ordinal	quin|gen|[té]|si|mo
quingentésimo	nome masculino	quin|gen|[té]|si|mo
quingentésimo	número fraccional	quin|gen|[té]|si|mo
quingentésimo	adjetivo	quin|gen|[té]|si|mo
quingombo	nome masculino	quin|[gom]|bo
quingosta	nome feminino	quin|[gos]|ta
quinguângua	adjetivo	quin|[guân]|gua
quinguângua	nome masculino	quin|[guân]|gua
quinguângua	nome feminino	quin|[guân]|gua
quingufo	nome masculino	quin|[gu]|fo
quinguila	nome feminino	quin|[gui]|la
quinguingu	nome masculino	quin|guin|[gu]
quingumbe	nome masculino	quin|[gum]|be
quingundo	adjetivo	quin|[gun]|do
quingundo	nome masculino	quin|[gun]|do
quingúri	nome masculino	quin|[gú]|ri
quinhame	nome masculino	qui|[nha]|me
quinhão	nome masculino	qui|[nhão]
quinhenta	nome feminino	qui|[nhen]|ta
quinhentismo	nome masculino	qui|nhen|[tis]|mo
quinhentista	adjetivo	qui|nhen|[tis]|ta
quinhentista	nome masculino	qui|nhen|[tis]|ta
quinhentista	nome feminino	qui|nhen|[tis]|ta
quinhentístico	adjetivo	qui|nhen|[tís]|ti|co
quinhentos	nome masculino	qui|[nhen]|tos
quinhentos	número cardinal	qui|[nhen]|tos
quinhentos	adjetivo	qui|[nhen]|tos
quinhentos-réis	nome masculino	qui|nhen|tos-réis
quinhoar	verbo	qui|nho|[ar]
quinhoeiro	nome masculino	qui|nho|[ei]|ro
quíni	nome masculino	[quí]|ni
quinica	nome masculino	qui|[ni]|ca
quinico	adjetivo	qui|[ni]|co
quinidina	nome feminino	qui|ni|[di]|na
quinimura	adjetivo	qui|ni|[mu]|ra
quiloso	adjetivo	qui|[lo]|so
quilostomatoplastia	nome feminino	qui|los|to|ma|to|plas|[ti]|a
quilostomatoplástico	adjetivo	qui|los|to|ma|to|[plás]|ti|co
quilóstomo	nome masculino	qui|[lós]|to|mo
quilotonelada	nome feminino	qui|lo|to|ne|[la]|da
quilovátio	nome masculino	qui|lo|[vá]|ti|o
quilovátio-hora	nome masculino	qui|lo|vá|ti|o-ho|ra
quilovolt	nome masculino	qui|[lo]|volt
quilovolt-ampere	nome masculino	qui|lo|volt-am|[pe]|re
quilovóltio-ampério	nome masculino	qui|lo|vól|ti|o-am|pé|ri|o
quilowatt	nome masculino	qui|[lo]|watt
quilowatt-hora	nome masculino	qui|lo|watt-ho|ra
quiluanje	nome masculino	qui|lu|[an]|je
quiluanza	nome feminino	qui|lu|[an]|za
quilúbio	nome masculino	qui|[lú]|bi|o
quilulo	nome masculino	qui|[lu]|lo
quilumba	nome feminino	qui|[lum]|ba
quilundo	nome masculino	qui|[lun]|do
quilunje	nome masculino	qui|[lun]|je
quilunza	nome feminino	qui|[lun]|za
quilunzar	verbo	qui|lun|[zar]
quilúria	nome feminino	qui|[lú]|ri|a
quilúrico	adjetivo	qui|[lú]|ri|co
quilúrico	nome masculino	qui|[lú]|ri|co
quimalanca	nome feminino	qui|ma|[lan]|ca
quimama	nome feminino	qui|[ma]|ma
quimana	nome feminino	qui|[ma]|na
quimanga	nome feminino	qui|[man]|ga
quimangata	nome feminino	qui|man|[ga]|ta
quimano	nome masculino	qui|[ma]|no
quimão	nome masculino	qui|[mão]
quimbala	nome feminino	quim|[ba]|la
quimbamba	nome feminino	quim|[bam]|ba
quimbanda	nome masculino	quim|[ban]|da
quimbanda	nome feminino	quim|[ban]|da
quimbanze	nome masculino	quim|[ban]|ze
quimbar	nome masculino	quim|[bar]
quimbári	nome masculino	quim|[bá]|ri
quimbemba	nome feminino	quim|[bem]|ba
quimbembé	nome masculino	quim|bem|[bé]
quimbembe	nome masculino	quim|[bem]|be
quimbembeques	nome masculino	quim|bem|[be]|ques
quimbete	nome masculino	quim|[be]|te
quimbimbe	nome masculino	quim|[bim]|be
quimbo	nome masculino	[quim]|bo
quimboa	nome feminino	quim|[bo]|a
quimbólio	nome masculino	quim|[bó]|li|o
quimbombeiro	nome masculino	quim|bom|[bei]|ro
quimbombo	nome masculino	quim|[bom]|bo
quimbondo	nome masculino	quim|[bon]|do
quimbuca	nome feminino	quim|[bu]|ca
quimbunda	nome feminino	quim|[bun]|da
quimbundo	nome masculino	quim|[bun]|do
quimbundo	adjetivo	quim|[bun]|do
quimé	nome masculino	qui|[mé]
quimenga	nome feminino	qui|[men]|ga
quimera	nome feminino	qui|[me]|ra
quimericamente	advérbio	qui|me|ri|ca|[men]|te
quimérico	adjetivo	qui|[mé]|ri|co
quimérida	nome masculino	qui|[mé]|ri|da
quimerídeo	nome masculino	qui|me|[rí]|de|o
quimerídeo	adjetivo	qui|me|[rí]|de|o
quimerista	nome masculino	qui|me|[ris]|ta
quimerista	nome feminino	qui|me|[ris]|ta
quimerizar	verbo	qui|me|ri|[zar]
quimi	nome masculino	qui|[mi]
quimiatria	nome feminino	qui|mi|a|[tri]|a
quimiátrico	adjetivo	qui|mi|[á]|tri|co
quimiatro	nome masculino	qui|mi|[a]|tro
química	nome feminino	[quí]|mi|ca
quimicamente	advérbio	qui|mi|ca|[men]|te
químico	nome masculino	[quí]|mi|co
químico	adjetivo	[quí]|mi|co
quimificação	nome feminino	qui|mi|fi|ca|[ção]
quimificar	verbo	qui|mi|fi|[car]
quimiluminescência	nome feminino	qui|mi|lu|mi|nes|[cên]|ci|a
quimiluminescente	adjetivo	qui|mi|lu|mi|nes|[cen]|te
quimioprofilaxia	nome feminino	qui|mi|o|pro|fi|la|[xi]|a
quimiorreceção	nome feminino	qui|mi|or|re|ce|[ção]
quimiorrecepção	nome feminino	qui|mi|or|re|cep|[ção]
quimiorreceptividade	nome feminino	qui|mi|or|re|cep|ti|vi|[da]|de
quimiorreceptivo	adjetivo	qui|mi|or|re|cep|[ti]|vo
quimiorreceptor	nome masculino	qui|mi|or|re|cep|[tor]
quimiorrecetividade	nome feminino	qui|mi|or|re|ce|ti|vi|[da]|de
quimiorrecetivo	adjetivo	qui|mi|or|re|ce|[ti]|vo
quimiorrecetor	nome masculino	qui|mi|or|re|ce|[tor]
quimiosfera	nome feminino	qui|mi|os|[fe]|ra
quimiossíntese	nome feminino	qui|mi|os|[sín]|te|se
quimiotáctico	adjetivo	qui|mi|o|[tác]|ti|co
quimiotactismo	nome masculino	qui|mi|o|tac|[tis]|mo
quimiotático	adjetivo	qui|mi|o|[tá]|ti|co
quimiotatismo	nome masculino	qui|mi|o|ta|[tis]|mo
quimiotaxia	nome feminino	qui|mi|o|ta|[xi]|a
quimioterapia	nome feminino	qui|mi|o|te|ra|[pi]|a
quimioterápico	adjetivo	qui|mi|o|te|[rá]|pi|co
quimiotripsina	nome feminino	qui|mi|o|trip|[si]|na
quimiotrópico	adjetivo	qui|mi|o|[tró]|pi|co
quimiotropismo	nome masculino	qui|mi|o|tro|[pis]|mo
quimismo	nome masculino	qui|[mis]|mo
quimitipia	nome feminino	qui|mi|ti|[pi]|a
querulência	nome feminino	que|ru|[lên]|ci|a
quérulo	adjetivo	[qué]|ru|lo
querusco	adjetivo	que|[rus]|co
querusco	nome masculino	que|[rus]|co
quescolheiro	adjetivo	ques|co|[lhei]|ro
quesito	nome masculino	que|[si]|to
quesitor	nome masculino	que|si|[tor]
quesível	adjetivo	que|[sí]|vel
questão	nome feminino	ques|[tão]
questão-chave	nome feminino	ques|tão-cha|ve
questionabilidade	nome feminino	ques|ti|o|na|bi|li|[da]|de
questionação	nome feminino	ques|ti|o|na|[ção]
questionado	adjetivo	ques|ti|o|[na]|do
questionador	adjetivo	ques|ti|o|na|[dor]
questionador	nome masculino	ques|ti|o|na|[dor]
questionadora	nome feminino	ques|ti|o|na|[do]|ra
questionamento	nome masculino	ques|ti|o|na|[men]|to
questionar	verbo	ques|ti|o|[nar]
questionário	nome masculino	ques|ti|o|[ná]|ri|o
questionável	adjetivo	ques|ti|o|[ná]|vel
questionavelmente	advérbio	ques|ti|o|na|vel|[men]|te
questiúncula	nome feminino	ques|ti|[ún]|cu|la
questor	nome masculino	ques|[tor]
questorado	nome masculino	ques|to|[ra]|do
questório	adjetivo	ques|[tó]|ri|o
questuário	adjetivo	ques|tu|[á]|ri|o
questuário	nome masculino	ques|tu|[á]|ri|o
questuoso	adjetivo	ques|tu|[o]|so
questura	nome feminino	ques|[tu]|ra
quetígero	adjetivo	que|[tí]|ge|ro
quetiliquê	nome masculino	que|ti|li|[quê]
quetilquê	nome masculino	que|til|[quê]
queto	adjetivo	[que]|to
quetodonte	nome masculino	que|to|[don]|te
quetófora	nome feminino	que|[tó]|fo|ra
quetofórea	nome feminino	que|to|[fó]|re|a
quetógnato	adjetivo	que|[tóg]|na|to
quetógnato	nome masculino	que|[tóg]|na|to
quetópode	nome masculino	que|[tó]|po|de
quetóptero	nome masculino	que|[tóp]|te|ro
quetua	nome masculino	que|[tu]|a
quetulo	nome masculino	que|[tu]|lo
quetumbá	nome masculino	que|tum|[bá]
quetzal	nome masculino	quet|[zal]
quevedo	nome masculino	que|[ve]|do
quevel	nome masculino	que|[vel]
queza	nome feminino	[que]|za
quezila	nome feminino	que|[zi]|la
quezilar	verbo	que|zi|[lar]
quezilento	adjetivo	que|zi|[len]|to
quezília	nome feminino	que|[zí]|li|a
qui	nome masculino	[qui]
quiá	nome masculino	qui|[á]
quiabeiro	nome masculino	qui|a|[bei]|ro
quiabo	nome masculino	qui|[a]|bo
quiaça	nome feminino	qui|[a]|ça
quiala	nome masculino	qui|[a]|la
quiáltera	nome feminino	qui|[ál]|te|ra
quiama	nome feminino	qui|[a]|ma
quiâmbi	nome masculino	qui|[âm]|bi
quiambo	nome masculino	qui|[am]|bo
quianda	nome feminino	qui|[an]|da
quianda-muchito	nome masculino	[qui]
quiangala	nome masculino	qui|an|[ga]|la
quiangala	nome feminino	qui|an|[ga]|la
quianja	nome feminino	qui|[an]|ja
quiasma	nome masculino	qui|[as]|ma
quiasma	nome feminino	qui|[as]|ma
quiasmático	adjetivo	qui|as|[má]|ti|co
quiasmo	nome masculino	qui|[as]|mo
quiástico	adjetivo	qui|[ás]|ti|co
quiastolita	nome feminino	qui|as|to|[li]|ta
quiastolite	nome feminino	qui|as|to|[li]|te
quiastólito	nome masculino	qui|as|[tó]|li|to
quiastolitóforo	adjetivo	qui|as|to|li|[tó]|fo|ro
quiastro	nome masculino	qui|[as]|tro
quiatumbandala	nome masculino	qui|a|tum|ban|[da]|la
quiaz	nome masculino	qui|[az]
quiba	adjetivo	[qui]|ba
quibaana	adjetivo	qui|ba|[a]|na
quibaana	nome masculino	qui|ba|[a]|na
quibaana	nome feminino	qui|ba|[a]|na
quibaca	nome feminino	qui|[ba]|ca
quibaco	nome masculino	qui|[ba]|co
quibala	nome feminino	qui|[ba]|la
quibala	adjetivo	qui|[ba]|la
quibala	nome masculino	qui|[ba]|la
quibamba	nome masculino	qui|[bam]|ba
quibanda	nome feminino	qui|[ban]|da
quibandar	verbo	qui|ban|[dar]
quibando	nome masculino	qui|[ban]|do
quibanga	nome feminino	qui|[ban]|ga
quibanha	nome feminino	qui|[ba]|nha
quibano	nome masculino	qui|[ba]|no
quibe	nome masculino	[qui]|be
quibeba	nome feminino	qui|[be]|ba
quibebe	nome masculino	qui|[be]|be
quibenza	nome feminino	qui|[ben]|za
quibeto	nome masculino	qui|[be]|to
quibiona	nome feminino	qui|bi|[o]|na
quarentenário	adjetivo	qua|ren|te|[ná]|ri|o
quarenteno	adjetivo	qua|ren|[te]|no
quarentia	nome feminino	qua|ren|[ti]|a
quarentona	nome feminino	qua|ren|[to]|na
quaresma	nome feminino	qua|[res]|ma
quaresmal	adjetivo	qua|res|[mal]
quaresmalmente	advérbio	qua|res|mal|[men]|te
quaresmar	verbo	qua|res|[mar]
quaresmeira	nome feminino	qua|res|[mei]|ra
quariate	adjetivo	qua|ri|[a]|te
quariate	nome masculino	qua|ri|[a]|te
quariate	nome feminino	qua|ri|[a]|te
quariúba	nome feminino	qua|ri|[ú]|ba
quark	nome masculino	[quark]
quaró	nome masculino	qua|[ró]
quarqueno	adjetivo	quar|[que]|no
quarqueno	nome masculino	quar|[que]|no
quarta	nome feminino	[quar]|ta
quartã	nome feminino	quar|[tã]
quartã	adjetivo	quar|[tã]
quarta-feira	nome feminino	quar|ta-fei|ra
quarta-feira	adjetivo	quar|ta-fei|ra
quartada	nome feminino	quar|[ta]|da
quartadecimano	nome masculino	quar|ta|de|ci|[ma]|no
quartado	adjetivo	quar|[ta]|do
quartaludo	adjetivo	quar|ta|[lu]|do
quartanário	adjetivo	quar|ta|[ná]|ri|o
quartanário	nome masculino	quar|ta|[ná]|ri|o
quartanista	nome masculino	quar|ta|[nis]|ta
quartanista	nome feminino	quar|ta|[nis]|ta
quartano	nome masculino	quar|[ta]|no
quartão	nome masculino	quar|[tão]
quartapisa	nome feminino	quar|ta|[pi]|sa
quartapisar	verbo	quar|ta|pi|[sar]
quartar	verbo	quar|[tar]
quartário	nome masculino	quar|[tá]|ri|o
quartau	nome masculino	quar|[tau]
quarteado	adjetivo	quar|te|[a]|do
quarteador	nome masculino	quar|te|a|[dor]
quartear	verbo	quar|te|[ar]
quarteio	nome masculino	quar|[tei]|o
quarteirão	nome masculino	quar|tei|[rão]
quarteiro	nome masculino	quar|[tei]|ro
quartejar	verbo	quar|te|[jar]
quartel	nome masculino	quar|[tel]
quartel-general	nome masculino	quar|tel-ge|ne|[ral]
quartel-mestre	nome masculino	quar|tel-mes|tre
quartela	nome feminino	quar|[te]|la
quartelada	nome feminino	quar|te|[la]|da
quartelado	adjetivo	quar|te|[la]|do
quarteleiro	nome masculino	quar|te|[lei]|ro
quartelismo	nome masculino	quar|te|[lis]|mo
quarteludo	adjetivo	quar|te|[lu]|do
quarterão	nome masculino	quar|te|[rão]
quarteto	nome masculino	quar|[te]|to
quartifalange	nome feminino	quar|ti|fa|[lan]|ge
quartifalangeta	nome feminino	quar|ti|fa|lan|[ge]|ta
quartifalanginha	nome feminino	quar|ti|fa|lan|[gi]|nha
quartil	nome masculino	quar|[til]
quartil	adjetivo	quar|[til]
quartilhada	nome feminino	quar|ti|[lha]|da
quartilhame	nome masculino	quar|ti|[lha]|me
quartilhar	verbo	quar|ti|[lhar]
quartilho	nome masculino	quar|[ti]|lho
quartimetatársico	adjetivo	quar|ti|me|ta|[tár]|si|co
quartinha	nome feminino	quar|[ti]|nha
quartinheiro	nome masculino	quar|ti|[nhei]|ro
quartinho	nome masculino	quar|[ti]|nho
quarto	nome masculino	[quar]|to
quarto	número fraccional	[quar]|to
quarto	número ordinal	[quar]|to
quarto	adjetivo	[quar]|to
quarto de final	nome masculino	[quar]|to de fi|nal
quarto-redondo	nome masculino	quar|to-re|[don]|do
quartodecimano	adjetivo	quar|to|de|ci|[ma]|no
quartodecimano	nome masculino	quar|to|de|ci|[ma]|no
quartola	nome feminino	quar|[to]|la
quartos de final	nome masculino	[quar]|tos de fi|nal
quártzico	adjetivo	[quárt]|zi|co
quartzífero	adjetivo	quart|[zí]|fe|ro
quartziforme	adjetivo	quart|zi|[for]|me
quartzite	nome feminino	quart|[zi]|te
quartzítico	adjetivo	quart|[zí]|ti|co
quartzito	nome masculino	quart|[zi]|to
quartzo	nome masculino	[quart]|zo
quartzoso	adjetivo	quart|[zo]|so
quasar	nome masculino	qua|[sar]
quase	advérbio	[qua]|se
quási	advérbio	[quá]|si
quasimodal	adjetivo	qua|si|mo|[dal]
quasímodo	nome masculino	qua|[sí]|mo|do
quassação	nome feminino	quas|sa|[ção]
quássia	nome feminino	[quás]|si|a
quassina	nome feminino	quas|[si]|na
quassite	nome feminino	quas|[si]|te
quaternado	adjetivo	qua|ter|[na]|do
quaternário	adjetivo	qua|ter|[ná]|ri|o
quaternário	nome masculino	qua|ter|[ná]|ri|o
quaternião	nome masculino	qua|ter|ni|[ão]
quaternidade	nome feminino	qua|ter|ni|[da]|de
queirã	nome feminino	quei|[rã]
queira	nome feminino	[quei]|ra
queiró	nome feminino	quei|[ró]
queiroga	nome feminino	quei|[ro]|ga
queirosiana	nome feminino	quei|ro|si|[a]|na
queirosiano	nome masculino	quei|ro|si|[a]|no
queirosiano	adjetivo	quei|ro|si|[a]|no
queixa	nome feminino	[quei]|xa
queixa-crime	nome feminino	quei|xa-cri|me
queixada	nome feminino	quei|[xa]|da
queixada	nome masculino	quei|[xa]|da
queixagem	nome feminino	quei|[xa]|gem
queixal	nome masculino	quei|[xal]
queixal	adjetivo	quei|[xal]
queixar	verbo	quei|[xar]
queixeiro	adjetivo	quei|[xei]|ro
queixinhas	nome masculino	quei|[xi]|nhas
queixinhas	adjetivo	quei|[xi]|nhas
queixinhas	nome feminino	quei|[xi]|nhas
queixo	nome masculino	[quei]|xo
queixosa	nome feminino	quei|[xo]|sa
queixosamente	advérbio	quei|xo|sa|[men]|te
queixoso	adjetivo	quei|[xo]|so
queixoso	nome masculino	quei|[xo]|so
queixudo	adjetivo	quei|[xu]|do
queixume	nome masculino	quei|[xu]|me
quejadilho	nome masculino	que|ja|[di]|lho
quejando	adjetivo	que|[jan]|do
quejando	nome masculino	que|[jan]|do
quele	nome masculino	[que]|le
queles	nome masculino	[que]|les
queleto	nome masculino	que|[le]|to
quelha	nome feminino	[que]|lha
quelho	nome masculino	[que]|lho
quelhório	nome masculino	que|[lhó]|ri|o
quelícera	nome feminino	que|[lí]|ce|ra
quelicerado	nome masculino	que|li|ce|[ra]|do
quelicerado	adjetivo	que|li|ce|[ra]|do
quelídida	nome masculino	que|[lí]|di|da
quelidídeo	nome masculino	que|li|[dí]|de|o
quelidídeo	adjetivo	que|li|[dí]|de|o
quelidídeo	nome masculino	que|li|[dí]|de|o
quelidônia	nome feminino	que|li|[dô]|ni|a
quelidónia	nome feminino	que|li|[dó]|ni|a
quelidónia-menor	nome feminino	que|li|dó|ni|a-me|nor
quelidônico	adjetivo	que|li|[dô]|ni|co
quelidónico	adjetivo	que|li|[dó]|ni|co
quelidonina	nome feminino	que|li|do|[ni]|na
quelidoxantina	nome feminino	que|li|do|xan|[ti]|na
quélidro	nome masculino	[qué]|li|dro
quelim	adjetivo	que|[lim]
quelim	nome masculino	que|[lim]
quelim	nome feminino	que|[lim]
quelimane	nome masculino	que|li|[ma]|ne
quelimane	adjetivo	que|li|[ma]|ne
quelimane	nome feminino	que|li|[ma]|ne
quelípode	nome masculino	que|[lí]|po|de
quelma	nome feminino	[quel]|ma
quelme	nome masculino	[quel]|me
quelocério	nome masculino	que|lo|[cé]|ri|o
quelodonte	adjetivo	que|lo|[don]|te
quelóforo	nome masculino	que|[ló]|fo|ro
queloide	nome masculino	que|[loi]|de
quelonídeo	nome masculino	que|lo|[ní]|de|o
queloníida	nome masculino	que|lo|[ní]|i|da
queloniídeo	nome masculino	que|lo|ni|[í]|de|o
queloniídeo	adjetivo	que|lo|ni|[í]|de|o
quelónio	adjetivo	que|[ló]|ni|o
quelônio	adjetivo	que|[lô]|ni|o
quelónio	nome masculino	que|[ló]|ni|o
quelônio	nome masculino	que|[lô]|ni|o
quelónios	nome masculino	que|[ló]|ni|os
quelônios	nome masculino	que|[lô]|ni|os
quelonite	nome feminino	que|lo|[ni]|te
quelonófago	adjetivo	que|lo|[nó]|fa|go
quelonófago	nome masculino	que|lo|[nó]|fa|go
quelonografia	nome feminino	que|lo|no|gra|[fi]|a
quelonográfico	adjetivo	que|lo|no|[grá]|fi|co
quelonógrafo	nome masculino	que|lo|[nó]|gra|fo
queluzense	adjetivo	que|lu|[zen]|se
queluzense	nome masculino	que|lu|[zen]|se
queluzense	nome feminino	que|lu|[zen]|se
quem	pronome indefinido	[quem]
quem	pronome interrogativo	[quem]
quem	pronome relativo	[quem]
quemose	nome feminino	que|[mo]|se
quende	nome masculino	[quen]|de
quendo	nome masculino	[quen]|do
quenga	nome feminino	[quen]|ga
quengada	nome feminino	quen|[ga]|da
quengo	nome masculino	[quen]|go
quenhar	verbo	que|[nhar]
queniana	nome feminino	que|ni|[a]|na
queniano	adjetivo	que|ni|[a]|no
queniano	nome masculino	que|ni|[a]|no
quenocólico	adjetivo	que|no|[có]|li|co
quenopodiácea	nome feminino	que|no|po|di|[á]|ce|a
quenopodiáceo	adjetivo	que|no|po|di|[á]|ce|o
quenopódio	nome masculino	que|no|[pó]|di|o
quenquém	nome feminino	quen|[quém]
quebrachina	nome feminino	que|bra|[chi]|na
quebracho	nome masculino	que|[bra]|cho
quebrada	nome feminino	que|[bra]|da
quebradamente	advérbio	que|bra|da|[men]|te
quebradeira	nome feminino	que|bra|[dei]|ra
quebradela	nome feminino	que|bra|[de]|la
quebradiço	adjetivo	que|bra|[di]|ço
quebrado	nome masculino	que|[bra]|do
quebrado	adjetivo	que|[bra]|do
quebrador	adjetivo	que|bra|[dor]
quebrador	nome masculino	que|bra|[dor]
quebradouro	nome masculino	que|bra|[dou]|ro
quebradura	nome feminino	que|bra|[du]|ra
quebralhão	nome masculino	que|bra|[lhão]
quebralhão	adjetivo	que|bra|[lhão]
quebramento	nome masculino	que|bra|[men]|to
quebrança	nome feminino	que|[bran]|ça
quebrançoso	adjetivo	que|bran|[ço]|so
quebrantado	adjetivo	que|bran|[ta]|do
quebrantador	adjetivo	que|bran|ta|[dor]
quebrantador	nome masculino	que|bran|ta|[dor]
quebrantadura	nome feminino	que|bran|ta|[du]|ra
quebrantamento	nome masculino	que|bran|ta|[men]|to
quebrantar	verbo	que|bran|[tar]
quebrantável	adjetivo	que|bran|[tá]|vel
quebranto	nome masculino	que|[bran]|to
quebrar	verbo	que|[brar]
quebratura	nome feminino	que|bra|[tu]|ra
quebrável	adjetivo	que|[brá]|vel
quebreira	nome feminino	que|[brei]|ra
quebro	nome masculino	[que]|bro
queca	nome feminino	[que]|ca
queche	nome masculino	[que]|che
quéchua	nome masculino	[qué]|chu|a
quéchua	nome feminino	[qué]|chu|a
quéchua	adjetivo	[qué]|chu|a
queda	nome feminino	[que]|da
queda-d'água	nome feminino	que|da-d´á|gua
quedamento	nome masculino	que|da|[men]|to
quedano	nome masculino	que|[da]|no
quedar	verbo	que|[dar]
quede	advérbio	[que]|de
quedes	nome masculino	[que]|des
quediva	nome masculino	que|[di]|va
quedivato	nome masculino	que|di|[va]|to
quedive	nome masculino	que|[di]|ve
quedo	adjetivo	[que]|do
quefazer	nome masculino	que|fa|[zer]
quefazeres	nome masculino	que|fa|[ze]|res
quefir	nome masculino	que|[fir]
quefirina	nome feminino	que|fi|[ri]|na
quefiroterapia	nome feminino	que|fi|ro|te|ra|[pi]|a
quefiroterápico	adjetivo	que|fi|ro|te|[rá]|pi|co
queguelequeze	nome masculino	que|gue|le|[que]|ze
queijada	nome feminino	quei|[ja]|da
queijadeiro	adjetivo	quei|ja|[dei]|ro
queijadeiro	nome masculino	quei|ja|[dei]|ro
queijadilho	nome masculino	quei|ja|[di]|lho
queijadinha	nome feminino	quei|ja|[di]|nha
queijar	verbo	quei|[jar]
queijaria	nome feminino	quei|ja|[ri]|a
queijeira	nome feminino	quei|[jei]|ra
queijeiro	nome masculino	quei|[jei]|ro
queijeiro	adjetivo	quei|[jei]|ro
queijinho	nome masculino	quei|[ji]|nho
queijinho do céu	nome masculino	quei|[ji]|nho do céu
queijo	nome masculino	[quei]|jo
queijoso	adjetivo	quei|[jo]|so
queilite	nome feminino	quei|[li]|te
queilodiptérida	nome masculino	quei|lo|dip|[té]|ri|da
queilodipterídeo	nome masculino	quei|lo|dip|te|[rí]|de|o
queilodipterídeo	nome masculino	quei|lo|dip|te|[rí]|de|o
queilodipterídeo	adjetivo	quei|lo|dip|te|[rí]|de|o
queima	nome feminino	[quei]|ma
queima	nome masculino	[quei]|ma
queima-roupa	nome feminino	quei|ma-rou|pa
queimação	nome feminino	quei|ma|[ção]
queimada	nome feminino	quei|[ma]|da
queimadeira	nome feminino	quei|ma|[dei]|ra
queimadeiro	nome masculino	quei|ma|[dei]|ro
queimadela	nome feminino	quei|ma|[de]|la
queimado	adjetivo	quei|[ma]|do
queimado	nome masculino	quei|[ma]|do
queimadoiro	nome masculino	quei|ma|[doi]|ro
queimador	nome masculino	quei|ma|[dor]
queimador	adjetivo	quei|ma|[dor]
queimadora	nome feminino	quei|ma|[do]|ra
queimadouro	nome masculino	quei|ma|[dou]|ro
queimadura	nome feminino	quei|ma|[du]|ra
queimamento	nome masculino	quei|ma|[men]|to
queimante	adjetivo	quei|[man]|te
queimante	nome masculino	quei|[man]|te
queimão	nome masculino	quei|[mão]
queimão	adjetivo	quei|[mão]
queimar	verbo	quei|[mar]
queimarço	nome masculino	quei|[mar]|ço
queimável	adjetivo	quei|[má]|vel
queimo	nome masculino	[quei]|mo
queimor	nome masculino	quei|[mor]
queimoso	adjetivo	quei|[mo]|so
quirera	nome feminino	qui|[re]|ra
quirguistanês	adjetivo	quir|guis|ta|[nês]
quirguistanês	nome masculino	quir|guis|ta|[nês]
quirguistanesa	nome feminino	quir|guis|ta|[ne]|sa
quirguiz	nome masculino	quir|[guiz]
quirguiz	adjetivo	quir|[guiz]
quirguiz	nome feminino	quir|[guiz]
quiri	nome masculino	qui|[ri]
quiriba	nome feminino	qui|[ri]|ba
quiribatiano	adjetivo	qui|ri|ba|ti|[a]|no
quiribatiano	nome masculino	qui|ri|ba|ti|[a]|no
quírie	nome masculino	[quí]|ri|e
quirielêison	nome masculino	qui|ri|e|[lêi]|son
quirina	nome feminino	qui|[ri]|na
quirinopolitano	adjetivo	qui|ri|no|po|li|[ta]|no
quirinopolitano	nome masculino	qui|ri|no|po|li|[ta]|no
quírios	nome masculino	[quí]|ri|os
quiriquiri	nome masculino	qui|ri|qui|[ri]
quiriri	nome masculino	qui|ri|[ri]
quiriripitá	nome feminino	qui|ri|ri|pi|[tá]
quiriru	nome masculino	qui|ri|[ru]
quiritário	adjetivo	qui|ri|[tá]|ri|o
quirite	adjetivo	qui|[ri]|te
quirite	nome masculino	qui|[ri]|te
quirite	nome feminino	qui|[ri]|te
quirites	nome masculino	qui|[ri]|tes
quiroga	nome feminino	qui|[ro]|ga
quiroginasta	nome masculino	qui|ro|gi|[nas]|ta
quirografar	verbo	qui|ro|gra|[far]
quirografário	adjetivo	qui|ro|gra|[fá]|ri|o
quirográfico	adjetivo	qui|ro|[grá]|fi|co
quirógrafo	nome masculino	qui|[ró]|gra|fo
quirologia	nome feminino	qui|ro|lo|[gi]|a
quirológico	adjetivo	qui|ro|[ló]|gi|co
quirólogo	nome masculino	qui|[ró]|lo|go
quiromancia	nome feminino	qui|ro|man|[ci]|a
quiromante	nome masculino	qui|ro|[man]|te
quiromante	nome feminino	qui|ro|[man]|te
quiromântico	adjetivo	qui|ro|[mân]|ti|co
quirométrico	adjetivo	qui|ro|[mé]|tri|co
quirómetro	nome masculino	qui|[ró]|me|tro
quirômetro	nome masculino	qui|[rô]|me|tro
quiromiídeo	nome masculino	qui|ro|mi|[í]|de|o
quironecta	nome masculino	qui|ro|[nec]|ta
quironectídeo	nome masculino	qui|ro|nec|[tí]|de|o
quironeu	adjetivo	qui|ro|[neu]
quironomia	nome feminino	qui|ro|no|[mi]|a
quironômico	adjetivo	qui|ro|[nô]|mi|co
quironómico	adjetivo	qui|ro|[nó]|mi|co
quironómida	nome masculino	qui|ro|[nó]|mi|da
quironomídeo	nome masculino	qui|ro|no|[mí]|de|o
quironomídeo	adjetivo	qui|ro|no|[mí]|de|o
quirônomo	nome masculino	qui|[rô]|no|mo
quirónomo	nome masculino	qui|[ró]|no|mo
quiroplasto	nome masculino	qui|ro|[plas]|to
quiropodia	nome feminino	qui|ro|po|[di]|a
quiropodista	nome masculino	qui|ro|po|[dis]|ta
quiropodista	nome feminino	qui|ro|po|[dis]|ta
quiroprática	nome feminino	qui|ro|[prá]|ti|ca
quiroprático	nome masculino	qui|ro|[prá]|ti|co
quiroprático	adjetivo	qui|ro|[prá]|ti|co
quiropraxia	nome feminino	qui|ro|pra|[xi]|a
quiróptero	nome masculino	qui|[róp]|te|ro
quiróptero	adjetivo	qui|[róp]|te|ro
quiroscopia	nome feminino	qui|ros|co|[pi]|a
quiroscópico	adjetivo	qui|ros|[có]|pi|co
quiroteca	nome feminino	qui|ro|[te]|ca
quirotonia	nome feminino	qui|ro|to|[ni]|a
quirotônico	adjetivo	qui|ro|[tô]|ni|co
quirotónico	adjetivo	qui|ro|[tó]|ni|co
quirotribia	nome feminino	qui|ro|tri|[bi]|a
quisacá	nome feminino	qui|sa|[cá]
quíscalo	nome masculino	[quís]|ca|lo
quisimussi	nome masculino	qui|si|mus|[si]
quispá	nome masculino	quis|[pá]
quissanga	nome feminino	quis|[san]|ga
quissange	nome masculino	quis|[san]|ge
quissângua	nome feminino	quis|[sân]|gua
quissanguela	nome feminino	quis|san|[gue]|la
quissanje	nome masculino	quis|[san]|je
quissapo	nome masculino	quis|[sa]|po
quissarro	nome masculino	quis|[sar]|ro
quissassa	nome feminino	quis|[sas]|sa
quissemo	nome masculino	quis|[se]|mo
quissende	nome masculino	quis|[sen]|de
quissoco	nome masculino	quis|[so]|co
quissonde	nome masculino	quis|[son]|de
quissongo	nome masculino	quis|[son]|go
quissuaíli	nome masculino	quis|su|a|[í]|li
quissunzo	nome masculino	quis|[sun]|zo
quisto	nome masculino	[quis]|to
quisto	adjetivo	[quis]|to
quistoso	adjetivo	quis|[to]|so
quita	nome feminino	[qui]|ta
quita-merenda	nome feminino	qui|ta-me|[ren]|da
quita-sol	nome masculino	qui|ta-sol
quitaba	nome feminino	qui|[ta]|ba
quitabo	nome masculino	qui|[ta]|bo
quitaca	nome feminino	qui|[ta]|ca
quitacamba	nome feminino	qui|ta|[cam]|ba
